   w1|w1|w1|w1|w1|w1|w1|w1|w1|                                    w1|w1|w1|w1|w1|w1|w1|                                    w2|w1|w1|w1|w1|w1|w1|w1|w2|
w2|                        w2|w1|w1|w1|w1|w1|w1|w1|w1|w1|w1|w1|w2|                     w2|w1|w1|w1|w1|w1|w1|w1|w1|w1|w1|w1|w2|                     w2|
w2|                                                                                                                                                w2|
w2|                        w2|w1|w1|w1|w1|w2|   w2|w1|w1|w1|w1|w2|                     w2|w1|w1|w1|w2|   w2|w1|w1|w1|w1|w1|w2|                     w2|
w2|                        w2|            w2|   w2|            w2|                     w2|         w2|   w2|               w2|                     w2|
w2|                        w2|            w2|   w2|            w2|w1|w1|w2|   w2|w1|w1|w2|         w2|   w2|               w2|                     w2|
w2|                        w2|            w2|   w2|                     w2|   w2|                  w2|   w2|               w2|                     w2|
w2|                        w2|   w2|w1|w1|w2|   w2|w1|w1|w2|            w2|   w2|         w2|w1|w1|w2|   w2|w1|w1|w1|w2|   w2|                     w2|
w2|               w2|w1|w1|w2|   w2|                     w2|            w2|   w2|         w2|                        w2|   w1|w1|w2|   w2|w1|w1|w1|w2|
   w1|w1|w1|w2|   w2|            w2|                     w2|            w2|   w2|         w2|                        w2|         w2|   w2|
            w2|   w2|w1|w1|w1|w1|w2|                     w2|w1|w1|w1|w1|w2|   w2|w1|w1|w1|w2|                        w2|w1|w1|w1|w2|   w2|
            w2|                                                                                                                        w2|
            w2|   w2|w1|w1|w1|w1|w2|                     w2|w1|w1|w1|w1|w2|   w2|w1|w1|w1|w2|                        w2|w1|w1|w1|w2|   w2|
            w2|   w2|            w2|                     w2|            w2|   w2|         w2|                        w2|         w2|   w2|
            w2|   w2|            w2|                     w2|            w2|   w2|         w2|                        w2|         w2|   w2|
            w2|   w2|            w2|                     w2|            w2|   w2|         w2|w1|w1|w1|w1|w2|   w2|w1|w2|         w2|   w2|
            w2|   w2|            w2|w1|w1|w2|   w2|w1|w1|w2|            w2|   w2|                        w2|   w2|               w2|   w2|
            w2|   w2|                     w2|   w2|            w2|w1|w1|w2|   w2|w1|w1|w2|               w2|   w2|               w2|   w2|
            w2|   w2|                     w2|   w2|            w2|                     w2|               w2|   w2|               w2|   w2|
            w2|   w2|                     w2|   w2|            w2|                     w2|               w2|   w2|               w2|   w2|
            w2|   w2|                     w2|   w2|            w2|                     w2|               w2|   w2|               w2|   w2|
            w2|   w2|w1|w1|w1|w1|w1|w1|w1|w2|   w2|w1|w1|w1|w1|w2|                     w2|w1|w1|w2|w1|w1|w2|   w2|w1|w1|w1|w1|w1|w2|   w2|
            w2|                                                                                                                        w2|
            w2|   w2|w1|w1|w1|w1|w2|   w2|w1|w1|w1|w1|w1|w1|w1|w2|                     w2|w1|w1|w1|w1|w1|w2|   w2|w1|w1|w1|w1|w1|w2|   w2|
            w2|   w2|            w2|   w2|                     w2|                     w2|               w2|   w2|               w2|   w2|
            w2|   w2|            w2|   w2|                     w2|                     w2|               w2|   w2|               w2|   w2|
            w2|   w2|            w2|   w2|                     w2|                     w2|      w2|w1|w1|w2|   w2|w1|w1|w1|w2|   w2|   w2|
            w2|   w2|      w2|w1|w2|   w2|w1|w1|w1|w2|         w2|w1|w1|w2|   w2|w1|w1|w2|      w2|                        w2|   w2|   w2|
            w2|   w2|      w2|                     w2|                  w2|   w2|               w2|                        w2|   w2|   w2|
            w2|   w2|      w2|                     w2|                  w2|   w2|               w2|                        w2|   w2|   w2|
            w2|   w2|      w2|                     w2|w1|w1|w1|w1|w1|w1|w2|   w2|w1|w1|w1|w1|w1|w2                         w2|w1|w2|   w2|
            w2|   w2|w1|w1|w2|                                                                                                         w2|
            w2|                                    w2|w1|w1|w1|w1|w1|w1|w1|w1|w1|w1|w1|w1|w1|w1|w2|                        w2|w1|w1|w1|w2|
            w2|w1|w1|w1|w1|w2|                     w2|                                          w2|                        w2|            
                           w2|                     w2|                                          w2|                        w2|            
                           w2|                     w2|                                          w2|                        w2|            
                           w2|                     w2|                                          w2|                        w2|            
                           w2|w1|w1|w1|w1|w1|w1|w1|w2|                                          w2|w1|w1|w1|w1|w1|w1|w1|w1|w2|            