
     e
caaa   aaaaaaaaaaaaaaaaaaaaaaaac
b    n                         b
b                              b
b                              b
b                               
b                             n  
b                              
b                              b
b                              b
b                              b
b                              b
b  p                           b
b                              b
b                              b
b                              b
b                              b
b                            o b
b                              b
b                              b
b                              b
b                              b
b                              b
b                              b
b                              b
b                              b
                               b
 n                             b
                               b
b                              b
b                              b
b     o                   n    b
caaaaaaaaaaaaaaaaaaaaaaaa   aaac
                          g